++++++++++++++++
+          a A0+
+           aAA+
+             a+
+              +
+              +
+              +
+              +
++++++++++++++++
