++++++++++++++++
+              +
+       0      +
+     aAA      +
+    aAAa      +
+      a       +
++++++++++++++++
