+++++++++++
+0 A      +
+AAA A    +
+ A      A+
+       Aa+
+++++++++++
