red: 0,A
green: 1,B
blue: 2,C
orange: 3,T,E,S,L,V
cyan: I
++++++++++++++
+ TEST LEVEL +
++++IIIIII++++
+AB   B   B a+
+0  B   B    +
++++II+++++I++
+1    +B+  Ib+
+II++        +
+CEC+++II+++++
+BS2  +      +
+cT   I   3  +
+     +      +
+++++++      +
+ test level +
+ TEST LEVEL +
++++++++++++++