+++++++++++++++++++
+                 +
+                 +
+                 +
+                 +
+        0        +
+       AB        +
+       ba        +
+                 +
+                 +
+                 +
+++++++++++++++++++
