red: 1, B, F, H, G
green: 0,A
blue: 2, C, K, I
magenta: 3, D
cyan: 4, E
++++++++++++++++++++++++++++
+c    1 gG      hH 4   Aa  +
+C    0                Bb  +
+ +++++++++++++++++Ee  Dd  +
+              23          +
+                          +
+    kK   iI               +
++++++++++++++++++++++++++++
