red: 0,A,C
green: 1,B
++++++++++++++++++++++++++++
+             0        Aa  +
+     1                Bb  +
+ +++++++++++++++++    Cc  +
+                          +
++++++++++++++++++++++++++++
