red: 1, B
green: 0,A
++++++++++++++++++++++++++++
+     1                Aa  +
+     0                Bb  +
+ +++++++++++++++++        +
+                          +
++++++++++++++++++++++++++++
